"filename", "language", "Dart", "comment", "blank", "total"
"c:\Users\dheen\Desktop\UFin\ufin\lib\screens\payment-screen\payment_screen.dart", "Dart", 7, 0, 0, 7
"c:\Users\dheen\Desktop\UFin\ufin\lib\screens\planner-screen\budget\budget_edit.dart", "Dart", 23, 0, 2, 25
"c:\Users\dheen\Desktop\UFin\ufin\lib\screens\planner-screen\planner_screen.dart", "Dart", 0, -3, 1, -2
"c:\Users\dheen\Desktop\UFin\ufin\lib\screens\planner-screen\text-ingsit\text_ingites_data.dart", "Dart", 41, 0, 2, 43
"c:\Users\dheen\Desktop\UFin\ufin\lib\screens\setting-screens\commitments\commitments_edit.dart", "Dart", -2, -1, 0, -3
"c:\Users\dheen\Desktop\UFin\ufin\lib\screens\setting-screens\commitments\commitments_setting.dart", "Dart", 7, 12, 0, 19
"c:\Users\dheen\Desktop\UFin\ufin\lib\screens\setting-screens\income\income_setting.dart", "Dart", 9, 0, 0, 9
"c:\Users\dheen\Desktop\UFin\ufin\lib\screens\setting-screens\personal\personal_setting.dart", "Dart", 1, 0, 0, 1
"c:\Users\dheen\Desktop\UFin\ufin\lib\screens\setup-screens\budget\budget_info.dart", "Dart", 22, 0, 1, 23
"c:\Users\dheen\Desktop\UFin\ufin\lib\screens\setup-screens\budget\budget_reorder.dart", "Dart", 120, 0, 10, 130
"Total", "-", 228, 8, 16, 252